###########################
#######aa@@,,,,,,,@@#######
###@##,,,,,,,,,,,@@@ss#####
#@@###,,,a,,,,,s,,@@@,,,###
####,,,,,,,s,,,,,,,,,,,####
###,,,,,,,111,,,,,@,,@@,@##
##,,,,,,222221,,aa,,,,,,,@#
#@#,,,,22233221,,,,,,@,,###
###,,,2233333221,,,s,,,,###
#@,,,223333322221,,,,a,####
###,,12233333332211,@,#####
###,,,,22333333322,,##@@###
#@###,,,,2222222,,ass###@##
##@@###,,,,,a,,,,,,,,##@@##
###########################

