##########
####,#####
###,,##a##
##,,,#,,,#
#s,,,,,,##
#,,,,,,,,#
##,,,s,,##
###22#,,,#
##2222#,,#
###2222,,#
####2222,#
#####22###
##########
