#############
#####,,######
###,,,s,##a##
##,,,#,,,,,##
#s,,a@@,,,,##
#,,,,,,,,s,,#
##@,,,,,s,,##
###2222#,,,,#
##223322#,,,#
##233332,,,##
##22233322,,#
##@@#222#,###
#############
